*******
*i|e|p*
*-*-*-*
*m| |m*
*-*-*-*
* |e|p*
*******